XXXXXXXXXXX
P         X
X X XXXXX X
X X X   X X
X X X XXX X
X X X X   X
XXX X X XXX
X   X X   X
X X X XXX X
X X X X   X
X XXX X XXX
X     X   X
XXXXXXXXXKX
